   
   
   
    wwwwwwwwwwwww
    w           w
    w           w         wwwwww
    w           w         w    w
    w  wwwww    w         w    w
    w  w   w    wwwwwwwwwww    w
    w  w e w                   w
    w  w   w                s  w
    w  w   w                   w
    w           wwwwwwwwwww    w
    w           w         w    w
    w           w         w    w
    w           w         wwwwww
    w           w          
    wwwwwwwwwwwww